%%%%
% .%
%  %
%P %
%  %
% .%
%%%%
